        1111111111111111111111111
        1000000000110000000000001
        1011000001110000000000001
1001000000000000000000001111111111111111
1111111110110000011100000000000000000011
1000000000110000011101111111111111111111
1111011111111101110000001000111111111111
1111S11111111101110101001000111111111111
1100000011010101110000001010111111111111
1000000000000000110000001100111111111111
10000000000000001101010010001
11000000110101011100000010101
10000000000000001100000011001
10000000010000001101010010001
11000000100101011100000010101
10000000000000001100000011001
10000000000000001101010010001
1100000111010101111101101000111
11110111 1110101 10111100000111111111111
11111111 1111111 11111111111111111111111